# Keywords for the Telnet library.
Telnet	KEYWORD1
TelnetStream	KEYWORD1
ETHTelnet	KEYWORD1
ETHTelnetStream	KEYWORD1

# Keywords for TelnetBase
begin	KEYWORD2
stop	KEYWORD2
loop	KEYWORD2
getIP	KEYWORD2
disconnectClient	KEYWORD2
getLastAttemptIP	KEYWORD2
onConnect	KEYWORD2
onConnectionAttempt	KEYWORD2
onReconnect	KEYWORD2
onDisconnect	KEYWORD2
onInputReceived	KEYWORD2
emptyClientStream	KEYWORD2
isConnected	KEYWORD2
getClient	KEYWORD2
getTimeoutInterval	KEYWORD2
setTimeoutInterval	KEYWORD2

# Keywords for Telnet
isLineModeSet	KEYWRORD2
setLineMode	KEYWRORD2
getNewlineCharacter	KEYWRORD2
setNewlineCharacter	KEYWRORD2
print	KEYWRORD3
println	KEYWRORD3
printf	KEYWRORD3
vprintf	KEYWRORD3

# Keywords for TelnetStream
available	KEYWRORD3
read	KEYWRORD3
peek	KEYWRORD3
flush	KEYWRORD3
write	KEYWRORD3

# Keywords for Escape
home	KEYWORD2
cls	KEYWORD2
clearLine	KEYWORD2
clearEoLine	KEYWORD2
cursorXY	KEYWORD2
cursorUp	KEYWORD2
cursorDown	KEYWORD2
cursorLeft	KEYWORD2
cursorRight	KEYWORD2
setBG	KEYWORD2
setFG	KEYWORD2
bold	KEYWORD2
italic	KEYWORD2
underline	KEYWORD2
blink	KEYWORD2
inverse	KEYWORD2
showCursor	KEYWORD2
reset	KEYWORD2

ANSI_BLACK	LITERAL1
ANSI_RED	LITERAL1
ANSI_GREEN	LITERAL1
ANSI_YELLOW	LITERAL1
ANSI_BLUE	LITERAL1
ANSI_MAGENTA	LITERAL1
ANSI_CYAN	LITERAL1
ANSI_WHITE	LITERAL1
ANSI_GREY	LITERAL1
ANSI_BRIGHT_RED	LITERAL1
ANSI_BRIGHT_GREEN	LITERAL1
ANSI_BRIGHT_YELLOW	LITERAL1
ANSI_BRIGHT_BLUE	LITERAL1
ANSI_BRIGHT_MAGENTA	LITERAL1
ANSI_BRIGHT_CYAN	LITERAL1
ANSI_BRIGHT_WHITE	LITERAL1
